13 15
 S -1 -1 -1 -1 -1 -1 -1 -1 -1 -1 -1 -1
 1 -1  1  1  1  1  1  1  1  1  1  1 -1
 1 -1  1 -1 -1 -1 -1  1 -1  1 -1 -1 -1
 1 -1  1 -1  1  1  1  1 -1  1 -1 -1 -1
 1 -1  1 -1  1 -1 -1 -1  1  1 -1 -1 -1
 1 -1  1 -1  1  1  1  1  1 -1 -1 -1 -1
 1  1  1  1  1 -1 -1 -1  1 -1 -1 -1 -1
 1 -1 -1 -1 -1 -1 -1  1 -1 -1 -1 -1 -1
 1 -1  1  1  1  1  1  1 -1 -1 -1 -1 -1
 1 -1  1 -1 -1 -1 -1  1 -1 -1 -1 -1 -1
 1 -1  1 -1  1  1  1  1  1  1  1  1 -1
 1 -1  1 -1  1 -1 -1 -1 -1 -1 -1  1 -1
 1 -1  1  1  1  1  1  1  1  1  1  1 -1
 1  1  1 -1 -1 -1 -1  1 -1 -1  1  1 -1
-1 -1 -1 -1 -1 -1 -1  E -1 -1 -1 -1 -1