8 8
 S -1 -1 -1 -1 -1 -1 -1
 1 -1  1  1  1  1  1  1
 1 -1  1 -1 -1 -1 -1  1
 1 -1  1 -1  1  1  1  1
 1 -1  1 -1  1 -1 -1 -1
 1 -1  1 -1  1  1  1  1
 1  1  1 -1 -1 -1 -1  1
-1 -1 -1 -1 -1 -1 -1  E